330333033303333000-
030303030303003000-
030303030303003000-
030303030303003000-
030303030303003000-
030303030303003000-
033303330333003333-
000000000000000000